1111111111
100P000001
1000000c01
100000c0c1
1000c00c01
100c00c001
1c000c0001
1111111111