111111111
10C0000E1
100P00001

100000001
111111111